; a comment!
113	A number that appears in many places in the court.
Aata	An employee (Security guard??) of the court alongside [Shell](#shell), seems to be more senior than Shell
Adam	A boy with rashes; owner, and victim, of [Hetty](#hetty)
AdminBot	A secretarial [robot](#robots) who sits at the Admin desk at [RobotHQ](#robothq)
Agni	Hindu [fire](#fire) god; [psychopomp](#psychopomps)
AlchemyChart	An alchemical chart
Aly	Alistair [Kershaw](#kershaws); went to the [Forest](#gillitie)
AlyShirt	A shirt belonging to [Aly](#aly), which [Kat](#kat) now owns
Angel	What [robots](#robots) call [Kat](#kat)
AnimalCells	the Court’s large animal holding cells
AnimalLab	a Court research lab
Anja	Anja Donlan, [Kat](#kat)’s mother; Roma origin but lived mostly in Spain.
Ankou	Breton grim reaper; [psychopomp](#psychopomps)
Annan	Annan Waters, a wide river in a deep gorge which separates [Gunnerkrigg Court](#court) from [Gillitie Wood](#gillitie), the 'forrest'.
Annie	Antimony Carver, our protagonist ([fire](#fire) Head Girl)
AnnieCut	The cut on [Annie](#annie)’s ethereal face from [Jeanne](#jeanne)’s [sword](#sword)
AnnieJumper	[Annie](#annie)’s original school jumper
AntiGrav	An anti-gravity generator that [Kat](#kat) makes for a science fair, and converts to a "ship" (flier) later
AntimonySymbol	The alchemical symbol for antimony; associated with [Annie](#annie) and [Surma](#surma)
AntlerFae	‘that guy’ – big nose, sandy brown hair, can haz antlers
Anwyn	could be described as tree elves but they don’t call themselves that
Archery	Fun with bows and arrows!
Argument	Somewhere between a disagreement and a fight
Armour	protective plates and other such wearable items
Armoury	Place where lots of weapons are stored
Arsenic	A highly poisonous metalloid
Axe	Often used to chop wood
BadgerFae	‘him too’ – white hair, two black stripes, former badger
BakingDistraction	Otherwise known as [Plan Theta](#plantheta); Cunningly devised to distract others while sneaking around
Basil	Minotaur
Beacon	Safety tool given to [Annie](#annie), can summon [Eglamore](#eglamore) within 5 seconds; makes a [Valknut](#valknut) teleport when activated, much like [Brinnie](#brinnie)'s teleport
BeckyGround	A student
Bind	[Etheric](#etherics) binding, hold or constraint hoodoo
Bip	[Parley](#parley)’s teleportation. May be accompanied by BARGE.
Birds	Birds have wings and feathers, [Kat](#kat) and [Paz](#paz) are both fond of them
Birmingham	See [Zimmingham](#zimmingham)
BismuthSymbol	The alchemical symbol for bismuth; associated with the Court and its founding via the [Seed Bismuth](#seedbismuth)
Blackboard	Classroom surface for writing on with chalk sticks a.k.a. chalkboard if not black
BlackPen	A black marker pen used to draw faces. Used by the [Robot King](#robotking)
BlinkerStone	[Etheric](#etherics) lens device
Blood	Circulatory fluid, supposed to be internal
Blue	A crazy fairy obsessed with hair; friends with [Red](#red)
Blush	Happy/embarrassed/emotional
BlushFae	‘her too’ – dark pink hair, two rosy cheeks (likes to wang tomatoes?)
Boat	A vehicle for crossing [water](#water)
Bob	Bob Sutton, a gardener/maintainer of artificial habitats and keeper of [Young’s Park](#youngspark) with his wife, [Marcia](#marcia)
Bobby	A [robot](#robots) at the AnimalLab
BobEyes	A Magpie who competes with [CityFace](#cityface) for a bagel!
Bones	Calcified weight bearing structures in the body of vertebrates forming an endo-skeleton; represent death
Bonus	Extra pages at the end of the chapter
Boots	Made for walking
Boxbot	[A robot](#robots). [Terrible](#terrible) (<i>q.v.</i>). Not as good as [Robox](#robox).
Bridge	from Gunnerkrigg Court across the [Annan Water](#annan) to [Gillitie Wood](#gillitie)
Brinnie	Sultry childhood friend of [Surma](#surma), [Anja](#anja), [Donny](#donny), [Eglamore](#eglamore) &amp; co. Probably Brynhildr, the valkrie
Bud	Husband of [Lindsey](#lindsey), boys’ [dorm](#subdorm) monitor
Bugsy	Teacher Lady, or Teach. [Foley](#foley) teacher, rather be sleeping
Buzz	The buzzing in [Zimmy](#zimmy)'s head when the stimuli get too much
Buzzer	Bug shaped device for fooling the court’s student tracking system
Caduceus	“Herald’s staff” borne by Hermes/[Mercury](#mercury), symbol of commerce
Cards	A pack of playing cards
Castle	Where royalty live. Even space alien royalty.
Chemicals	May be used to perform terrifying skills of Chemistry or Alchemy
CherryTree	Comes as advertised; lives in a [Habitat](#habitat)
Chester	One of the other school Houses
Chickcharney	See [Hardwick &amp; Little’s Bestiary](#hardwicklittlebestiary), p65
Circus	Creepy and filled with clowns
CityFace	A pigeon
Classroom	Where they have classes
Clowns	Creepy, no-one likes them
Computer	You're using one right now. The court keeps student records, and many other things on computers.
Cookie	Cookie Monster(?), enthusiastic friend of [Parley](#parley)
Court	Gunnerkrigg Court, a mysterious institution that includes a boarding school
CourtHall	A large important hall for meetings
CourtLogo	Gunnerkrigg Court logo (for the school); Appears on detention slips and official school letters
CourtSymbol	The symbol [Annie](#annie)’s [Blinker Stone](#blinkerstone) makes; has a [Bismuth Symbol](#bismuthsymbol) within it
Courtyard	A courtyard near the [library](#library)
Cover	A chapter cover
Coyote	Trickster; the creator of all; he does not exist, he says
CoyoteStories	Stories told about or by [Coyote](#coyote)
CoyoteTooth	It’s a tooth, or is it?
CreatorGlyph	Mark of the [robot](#robots)’ creator: now associated with [Kat](#kat)
Creeper	Someone who is creeping
Crying	When salty water with enzymes comes out of one’s lacrimal ducts; also, a sign of sadness
CrystalBall	A crystal ball is traditionally used for scrying, future-telling or other Gypsy/Roma past-times
CurlyFae	‘this girl too’ -- short curly blue hair, red dot below right eye
CwnAnnwn	the Cŵn Annwn, spectral hounds of Annwn (the underworld), black dogs/[psychopomps](#psychopomps) of Wales; red ears
DanielRSchiff	A victim
Desert	No rain in here. Where [Coyotes](#coyote) live, sometimes.
Diego	creepy robotics expert of the Court's early days; creator of the original [robot](#robots) (but not the TicTocs); and referred to as "creator" by them. Implicated in the [Jeanne](#jeanne) affair
DiegoBot	One of the original [robot](#robots) created by Diego many years ago
DiegoStudy	Home of all things ancient [robot](#robots)
Dirty	What you become when you don't wash for a while
Divide	The division between the Court and the [Forest](#gillitie) caused by [Coyote](#coyote)
Dolls	[Kat](#kat) probably only has action figures she thinks are hot: <i>i.e.</i> David Duchovny (Mulder), Batman and Hellboy
DonlanHouse	Home of the Donlan family: [Anja](#anja), [Donny](#donny), [Kat](#kat)
DonlanSymbol	A symbol found in the Donlan house and in [Anja](#anja) &amp; [Donny](#donny)'s program; resembles the alchemical symbols for silver and ether
Donny	Donald Donlan, [Kat](#kat)’s father
DoorBot	A cranky old man [robot](#robots) who guards the door to the [RobotHQ](#robothq)
Dorm	Living quarters at school
DrDisaster	Sends the students on hologram simulation adventures!
Dryad	Folk who can control and travel through the trees themselves, [Marcia](#marcia) is one.
Earth	Ancient element; the planet on which we live; the great mother and life-giver
Eglamore	Sir James Eglamore/Jimmy/Jim/James/Eggers. Big fellow with [sword](#sword)
EglamoreKnife	A switchblade/flick knife present that [Eglamore](#eglamore) treasures
EglamoreOffice	Where [Eglamore](#eglamore) hangs out; contains [swords](#sword), [armour](#armour), a [Tiki](#tiki) and a [mask](#mask) among other things
Employees	Miscellaneous Court employees; includes security staff, gardeners, scientists, [power station](#powerstation) operators and even mysterious dudes who take [Gamma](#gamma) and [Zimmy](#zimmy) from [Birmingham](#birmingham) to the Court
EnigmaronLair	Where the [Enigmarons](#enigmarons) from a [Dr. Disaster](#drdisaster) [simulation](#simulation) hang out
Enigmarons	Bad guy aliens in a [Dr. Disaster](#drdisaster) [simulation](#simulation)
Etherics	Manipulation of the Ether – “magic”
EthericShield	An [Etheric](#etherics)/magical shield
Etherium	The world/realm of the Ether
EtherSymbol	A symbol for phlogiston or ether
EugeneGould	Explorer
EyeCrossed	A crossed out eye that is a complex warding sign, made by [Anja](#anja) and [Donny](#donny) to bind [Rey](#rey)
EyeGunk	[Etheric](#etherics) eye-gunk possessed by [Zimmy](#zimmy) and others affected by [Zimmingham](#zimmingham)
Eyes	When seeing is important
EyeSymbol	An eye symbol associated with [Coyote](#coyote) and [Gillitie](#gillitie)
FacelessPeople	People without faces who [Zimmy](#zimmy) sometimes sees
Fairies	[Gillitie](#gillitie) Wood is full of them
FencingHall	Where [sword](#sword)-fighting, fencing, sparring are taught
Fight	When two people have a disagreement, violently
Filler	Not a mainstream story comic
Fire	An ancient element; may cause [smoke](#smoke)
FireElemental	A personification of [fire](#fire), represented with a [FireSpike](#firespike) on their head
FireHose	A hose to put out a [fire](#fire)
FireSpike	A spiky [fire](#fire) crown associated with [Fire Elementals](#fireelemental)
FireSymbol	The alchemical symbol for [fire](#fire)
Fish	Aquatic animal, fish live in [water](#water) and breathe through gills
FishFae	‘a fish guy?’ -- concentrating on making himself handsome, former fish
Flashback	Things that happened in the past
FlowerFae	‘this one’ -- purple hair, green bar under left eye
FlowerHeadband	AKA het-band. Pink flower headband, bestows +5 straightness upon the wearer (-5 for a male)
Flowers	Colourful plants that grow from the ground. Often given as gifts.
Flying	Moving through the air, like superman
Foley	One of the other school Houses
ForestSymbol	The symbol [Gillitie](#gillitie) uses to message; has an “eye” within it
Founding	The founding of the court.
Gamma	Gamma Czarnecki, a quiet girl from Poland who only speaks Polish; friends with [Zimmy](#zimmy) who she met in [Birmingham](#zimmingham); a Greek letter &Gamma;/&gamma; equivalent to our letter "G"
Ghosts	sometimes haunt [mandolins](#mandolin)
Gillitie	Gillitie Wood, where the wild things are, _a.k.a._ The Forest
Glass	A transparent silicon oxide substance used to make windows and the water bearing vessels also called "glasses"
GlassFiber	Strands of glass used in insulation. Exposure causes itchiness and respiratory problems.
God	What is god?
Gol-shogeg	Big worm slug monster
GolemHeart	The core that makes the [robot](#robots) "work", if you will. Perhaps [etheric](#etherics)?
GoodHope	Good Hope Hospital is where [Surma](#surma) was before she died
GraveYard	a field of the dead
GreatSecret	[Coyote's](#coyote) Great Secret.
GreenArrow	Green arrow with horseshoe tip. Created by [Diego](#diego), shot by [Steadman](#steadman), hit Jeanne's Lover in the [Annan](#annan)
GreenFae	‘this other one’ -- long straight green hair
Grounds	The grounds/gardens of Gunnerkrigg Court
GroundSymbol	The electronic symbol for ground
GuestComic	Guest comic strips from end of Year 7/Book one
GurtDog	A black dog/[psychopomp](#psychopomps) of Somerset; protects children and travellers
Gym	School gymnasium
Gytrash	A black dog/[psychopomp](#psychopomps) of Northern England; mentioned in _Jane Eyre_ by Charlotte Bronte
Habitat	An environmental decontamination habitat
HabitatSymbol	The sign for an artificial habitat
HairdresserBot	a [robot](#robots) that cuts hair; lots of arms
Hall	Function hall [113](#113), a hall in the school
Hammer	A tool for driving nails into things or beating things into shape
HardwickLittleBestiary	Reference on mystical creatures
HarryPotter	Deserves to be taped to a flag pole for being a ponce
Headmaster	Jonathan Llanwellyn, [Janet](#janet)’s father; surprisingly grey, apathetic man, with bad posture
Heart	A heart, or heart sign, symbol, glyph or character; either the body's blood pump, the core of a mechanism or a symbol of love
HedgehogFae	‘and him’ -- dreads, former hedgehog
Hetty	a small animate devil doll, victimising [Adam](#adam)
HettySymbol	sometimes visible on [Hetty](#hetty)'s forehead
Hexagram	Means the art of alchemy, the quintessence or “fire-water”/alcohol; the Jewish Kingdom (Star of David)
Homework	School work done outside class hours
Horsebot	H model [Robot](#robots) in a horse frame, as motive power for carriages, carts etc
Hospital	The hospital/infirmary within the court
Hyland	[Jack](#jack)’s father and classmate of [Eglamore](#eglamore), [Donny](#donny), [Anja](#anja) and [Surma](#surma). Not very nice to [Anja](#anja) or [Surma](#surma).
Jack	Jack [Hyland](#hyland), in the same year as [Annie](#annie) and [Kat](#kat)
Jan	January, curt friend of [Parley](#parley)
Janet	Janet Llanwellyn; Fierce daughter of the [Headmaster](#headmaster); dating [Winsbury](#winsbury)
Jeanne	Vengeful ghost and guardian of the [Annan](#annan) waters, originally a fencer belonging to the court. _"She died and we did nothing"_
JeannesLover	Jeanne's [Anwyn](#anwyn) [forest](#gillitie) lover, name as yet unknown.
John	John Sullivan [[ref](http://gunnerkrigg.proboards.com/thread/361/tom-2?page=30&scrollTo=18295)] _a.k.a._ [Sullivan's John](www.gunnerkrigg.com/art/john.jpg). A musical student, plays strings _e.g._ guitar, [mandolin](#mandolin). Dating [Margo](#margo)
Jokes	Ha ha.
JollyElfsberry	A prancing elf, and alias of [Coyote](#coyote)
Jones	A mysterious court lady; name of [Wandering Eye](#wanderingeye)
JonesFootprints	Ancient footprints that appear to belong to [a human](#jones); how can this be?
Juliette	[Employee](#employees) of the court, is qualified to run the [Ether station](#powerstation)
JupiterMoonMartians	Friendly aliens in one of [Dr Disaster](#drdisaster)'s [simulations](#simulation)
Kamlen	[Anwyn](#anwyn) boy about [Annie](#annie)’s and [Kat](#kat)’s age
Kat	Katerina Donlan, the scientifically inclined best friend of [Annie](#annie), also close to [Paz](#paz); [Anja](#anja) & [Donny](#donny) Donlan's daughter, sometimes called Katja by her mother
KatsHomework	A thing that [Annie](#annie) copies
KatsWorkshop	Where [Kat](#kat) indulges her hobbies; in the West Canals; has a hidden room in the bottom
KershawHouse	Where [Aly](#aly) and his parents Mr and Mrs [Kershaw](#kershaws) used to live.
Kershaws	[Aly](#aly)'s parents. [birds](#birds).
Ketrak	[Psychopomp](#psychopomps) to the insects!
Khepi	Head of an [Anwyn](#anwyn) family
Kiss	Smooshing, pashing, making out, a peck on the cheek, first base, kissing
Knight	A traditional warrior and military leader who is part of the landed gentry class; often trained in swordsmanship; a chess piece; _e.g._ [Eglamore](#eglamore) and [Sir Young](#siryoung).
Labyrinth	Not quite a maze
Lake	A large, still body of [water](#water); where the [power station](#powerstation) is.
Landscape	A view of a wide expanse of land
LaserCow	A [robotic](#robots) cow that mows the lawns with its laser eyes. Also, awesome. All go by the name Elsie
Lasers	Zap! Awesome!
Latin	A dead language, some things are written in it
LaundryList	A seagull
LeadSymbol	The alchemical symbol for lead; associated with protectors of the court such as [Eglamore](#eglamore)
LeanDog	A black dog/[psychopomp](#psychopomps) for Tring, Hertfordshire; red eyes.
Letter	A written communication
Library	Includes [robot](#robots) parts (!)
LighterFuel	notoriously flammable; accelerant
Lightning	Clouds and electricity... ZZZAAAPP!
Lindsey	[dorm](#subdorm) monitor, PhD Structural Engineering, accredited couples therapist, Merostomatozon; wife of [Bud](#bud)
LindseyComputer	[Lindsey](#lindsey)'s computer translates for her
Lockpicks	[Annie](#annie) has some lockpicks which she stores in the WolfToy/[Rey](#rey)’s body
LoveLetter	A written expression of love; may be anonymous
MakeUp	Cosmetics to define or enhance appearance, particulaly of the face, eyes and mouth
Mallt-y-nos	Matilda of the Night, Night Malt; Welsh [psychopomp](#psychopomps)/crone/witch; rides with the [Cŵn Annwn](#cwnannwn) (hounds of the underworld)
Mandolin	stringed musical instrument; sometimes they’re haunted
Marble	A shining sphere of unmelting ice; trapped inside were brilliant colours from the rarest flowers.
Marcia	Marcia Sutton, a [dryad](#dryad) and keeper of [Young’s Park](#youngspark) with her husband, [Bob](#bob)
Margo	A student who enjoys singing. Artist. Dating [John](#john)
MarineFae	‘and her’ -- aquamarine hair, vertical green bar on forehead
Martin	A young boy who has "lost his way" and whom young [Annie](#annie) needs to help
MartinLizard	A lizard that [Martin](#martin) likes and shows [Annie](#annie). Bites.
MartinRoom	[Martin](#martin)'s hospital/bed room
Mask	A cover to hide face, appearance, emotions
Matches	playing with matches can start fires
Matt	Student and classmate of [Annie](#annie) and [Kat](#kat)
Mercury	A poisonous liquid metal; otherwise known as quicksilver; Mercury or Hermes was the son of Apollo, the trickster messenger god of medicine and commerce; [psychopomp](#psychopomps)
MercurySymbol	The alchemical symbol for [mercury](#mercury); appears on [Rey](#rey)’s spirit form
MetalGearSolid	A game that [Kat](#kat) likes.
Mice	Small rodents, common pests, and also in labs.
Microsat5	[Tony](#tony)’s payload delivery satellite
ModdeyDhoo	One of the Black Dogs, a [psychopomp](#psychopomps) from the Isle of Man
Monster	A scary creature
Montgomery	A [Seraph](#seraph) [robot](#robots)
Monument	A physical tribute to a well respected person
Moon	Our most ancient satellite!
MoonGirl	Chang’e ([ref](www.gunnerkrigg.com/?p=920)), a deity or personification of the Moon
MoonPrint	Thumbprint on the moon
Mort	A [ghost](#ghosts) who haunts part of the school
MrThorn	Mr Thorn, Court protector and games teacher to [Annie](#annie) and [Kat](#kat)’s parents
Music	Everyone loves music!
Muut	Egyptian [psychopomp](#psychopomps) (escorts the dead to the afterlife)
NancyDrew	A series of books featuring a teenage girl solving mysteries
NapoleonHat	A fitting hat for [Reynardine](#rey) the Great!
Neith	Egyptian goddess of war; [psychopomp](#psychopomps)
Nevihta	Rogat Orjak to [Sir Young](#siryoung), first protector of the court
Observatory	A massive telescope
Ocean	A whole bunch of [water](#water)
Octopus	A flying / floating octopus
Ogee	A city fairy with the power of rusting, who hangs out with a magpie called [BobEyes](#bobeyes). Sister of [Torus](#torus)
OldCourt	Parts of Gunnerkrigg Court that used to be in [Gillitie Forest](#gillitie) before the division by [Coyote](#coyote).
Ooze	What [Martin](#martin)'s, lizard turns into when it hits the floor
Orb	The _Globus cruciger_, a Christian symbol of power, wielded by monarchs and Christ
Parley	George Parley: three years older than Antimony, swordswoman, teleports, candidate for Court medium ('Big Nose Girl'), interested in [Smitty](#smitty)
PartyHat	A Party hat, hats are fun!
Paz	Paz Cadena-Blanco, Spanish, good with animals and can talk to them; is raising [CityFace](#cityface) with [Bobby](#bobby); becomes close to [Kat](#kat).
Photo	A photograph of [Anja](#anja), [Donny](#donny), [Eglamore](#eglamore), [Surma](#surma), [Tony](#tony) and [Brinnie](#brinnie) from their school days
PlanTheta	[Baking Distraction](#bakingdistraction) for when others are sneaking around
Pliers	Used for manipulating wire; may include wire-strippers or wire-cutters
PowerStation	A Court system to extract energy from the [Etherium](#etherium) on an industrial scale
PrincessMononoke	Animated movie by Hayao Miyazaki
Psychopomps	Escort the dead to the afterlife/[Ether](#etherium)
Queslett	[Annie](#annie) &amp; [Kat](#kat)’s school House
Rain	[water](#water), falling from the sky
Red	A crazy and abrasive fairy
Rey	Reynardine, Reynard, Renard, a crafty fox spirit or demon from [Gillitie Wood](#gillitie)
ReyComic	A comic page authored by [Reynardine](#rey)
River	Comes as advertised
Robot	originally S-13, a messianic [Seraph](#seraph) class [robot](#robots)
RobotCode	A cube with the [Robots](#robots)' instruction code transcribed onto it
RobotDesigns	Designs and Blueprints for [robot](#robots) old and new
RobotHQ	Where the [robots](#robots) hang out
Robotics	Like [Etherics](#etherics) but with metal
RobotKing	A [robot](#robots) with a crown, blank face, and a pen
RobotParts	Bits of [robot](#robots) currently not attached
Robots	A collective noun
RobotTomb	Tomb/theatre full of [robot](#robots)
Robox	Has no hands; awesome; everybody loves Robox. The opposite of [terrible](#terrible)
Rocket	A cylindrical projectile that can be propelled to a great height or distance by the combustion of its contents.
RogatOrjak	Dragon-like giant
Roof	The top of the court
S1	Original [Seraph](#seraph) [robot](#robots) made by [Diego](#diego); predecessor of [Robot](#robot)
Salon	Court hair salon, staffed by the HairdresserBot
ScienceLab	A school science lab where [Kat](#kat) does her initial experiments and makings
Scissors	A simple device for cutting things, especially paper, hair
SecurityDevice	Small devices that supposedly warn [Jack](#jack) when people are coming
SecurityRobots	They ensure security, as [robot](#robots)
SeedBismuth	It’s a mystery; involved in the [founding](#founding) of the court
Seeds	Some seeds that [Ysengrin](#ysengrin) uses for his terrifying skills of gardening. Used to create the [WoodenArm](#woodenarm) and also dropped in the [Court Hall](#courthall).
Seraph	Generic member of the [Seraph](#seraph) model of [robot](#robots). [Robot](#robot) was one originally
Shadow	The Thin Man, a [shadowman](#shadowmen)
Shadowman	Not the Thin Man, but one of the [shadowmen](#shadowmen)
Shadowmen	The glass-eyed men; creations of [Coyote](#coyote)
Shell	An employee (Security guard??) of the court, alongside [Aata](#aata)
SimRocket	A rocket/spaceship in [Dr. Disaster](#drdisaster)’s [simulation](#simulation)
Simulation	One of [Dr. Disaster](#drdisaster)’s holographic adventures
SirYoung	Protector of the Court at its [founding](#founding)
Sivo	A [Rogat Orjak](#rogatorjak) who was close friends with [Eglamore](#eglamore)
SkullCrossbones	The skull and crossbones; a poison or toxin symbol; symbolises death; associated with pirates
Sky	Comes as advertised; full of stars; the universe; the "father" in mythology
SkyWatcher	A praying mantis-like [robot](#robots) that collects meteorological data
SmallBot	A young eye-witness model [robot](#robots)
Smitty	Andrew Smith ('Mighty Eyebrows Boy'), a student two years above Annie; brings order from chaos; interested in [Parley](#parley); becomes Court medium
Smoke	Where it is, there is often [fire](#fire)
Spankies	From [Annie](#annie) for when [Coyote](#coyote) is a Bad Dog!
Sparring	A mock or training fight; usually for learning or practising martial arts or swordfighting
Speakeasy	A hotel-like place that the students sneak out to with a “speakeasy-like atmosphere”
Spiders	Often white and [etheric](#etherics), also often real.
StarHeadband	A headband with stars on antennae that [Annie](#annie) uses to pretend she is a [robot](#robots)
Stars	Celestial bodies
Steadman	An archer, present at the [founding](#founding) of the court
StepsHouse	[Eglamore](#eglamore) lives here
StopBot	Model B [robot](#robots) with stop signs for heads and boxing glove arms
Students	Miscellaneous students
SubDorm	Year 9’s dorm: a retrofitted sub aquatic deep sea drilling platform. [Lindsey](#lindsey) and [Bud](#bud) are the dorm monitors.
SullivansJohn	see [John](#john)
Sun	Our closest [star](#stars)!
SunSymbol	Alchemical symbol for the Sun, doubles as the symbol for gold
Surma	Surma Stibnite, [Annie](#annie)’s mother
SurmaWhisper	[Surma](#surma) whispers something in the past to [Annie](#annie)
Sweets	Tasty and sugary
Sword	A long weapon with a blade held in one or two hands. Sometimes magical. Wielded by [Eglamore](#eglamore), [Parley](#parley), [Jeanne](#jeanne) among others
Symbol	some unidentified symbol (please help identify!)
Tea	Explains things in-between chapters
Teacher	A miscellaneous teacher
Tears	In the eyes, visibly crying, _etc_
Telescope	Good for seeing celestial bodies, satellites and other things that are far away
Tents	For sleeping inside, outside
Terrible	[BoxBot](#boxbot)
Thief	A robber, burglar, stealer.
Thornhill	One of the other school Houses
TicToc	Birdlike robotic watchers: the "Thousand Eyes"; [Zimmy](#zimmy) can feel its stare
Tiki	A Polynesian totem
TimeStop	When time is stopped from passing; [Coyote](#coyote) can do this.
Tom	Tom Siddell, author of Gunnerkrigg Court
TomatoWangFae	likes to wang tomatoes. friends with BlushFae
Tony	Anthony Carver, [Annie](#annie)’s father
Torus	A city fairy who deals with pigeons such as City Face. Sister of [Ogee](#ogee).
Tower	A tower in the Court where [Aly](#aly) stays, while transitioning
ToyShop	A toy shop in [Zimmingham](#zimmingham) where [Zimmy](#zimmy) and [Gamma](#gamma) meet up if they get separated
Train	One of many trains that is used to commute in the court
TrainStation	One of many stations in the court
Traitor	One who betrays their allies
Treatise	Symbolic representation of the story
TreeBody	[Ysengrin](#ysengrin)’s artificial tree-like body. His true body underneath is a physically weaker, much older wolf
TreeDog	They usually go woof, unless created by the [forest](#gillitie)
Trees	Come as advertised (usually)
Umbrella	Hand-held cover to keep the [rain](#rain) off.
Uniform	An outfit one wears when on official business
Valknut	A Norse triangular knot symbol, indicates a form of teleport/gateway such as that used by [Brinnie](#brinnie) or the [beacon](#beacon) that [Eglamore](#eglamore) gave to [Annie](#annie)
Veles	Ancient Slav snake-like god who guards the underworld; [psychopomp](#psychopomps)
VenusSymbol	A symbol for Venus/Aphrodite; also the symbol of females/femininity
VII	The number seven, numerologically symbolises virginity, change, completion of a cycle, luck, perfection
VincentPrice	A famous actor
WanderingEye	Symbol of that which calls itself [Jones](#jones), currently
Warehouse113	Warehouse [113](#113) is Not a secret base at Long Acre
Water	Ancient element; H2O; necessary for life; rivers, lakes and oceans are made of this
WaterFae	‘this girl’ – short blue spikey hair, 2 dots under right eye, had a waterfall?
WaterSymbol	Alchemical symbol for [water](#water)
WhiteRabbit	Every story begins with a rabbit (except the ones that don’t)
WhiteSpider	Also known as WhiteLegs, associated with [Jack](#jack) Hyland’s [etheric](#etherics) form when he got stuck in [Zimmingham](#zimmingham), until [Zimmy](#zimmy) helped him get rid of it
Winsbury	William (Willie) Winsbury; student with [Annie](#annie) and [Kat](#kat), not a very nice boy; dating [Janet](#janet)
Wisp	a misleading monster of [Gillitie Wood](#gillitie) (_see_ [Will-o'-the-Wisp](https://en.wikipedia.org/wiki/Will-o%27-the-wisp))
WolfToy	A small wolf toy made by [Annie](#annie)’s mother (tagged when _not_ animated by [Reynardine](#rey))
WoodenArm	A mysterious wooden arm from [Gillitie](#gillitie); initially attached to [Robot](#robot); finds its way to [Habitat](#habitat) [113](#113) and finally to [Young's Park](#youngspark)
WorkshopKey	The key for [Kat](#kat)'s Workshop
YellowFae	‘him’ - yellow hair, kinda sideways windswept
YoungBot	A large, bull-like [robot](#robots) made by [Diego](#diego) that resembles [Sir Young](#siryoung)
YoungsPark	A large park within the Court, looked after by [Bob](#bob) and his wife [Marcia](#marcia); named after [Sir Young](#siryoung), the original Protector of the Court
Ysengrin	Wolf/Tree hybrid demigod of the [forest](#gillitie); [Coyote](#coyote)’s General
ZAM	Noise of a [Valknut](#valknut) teleport
Zeta	A Greek letter &Zeta;/&zeta; corresponding to our "Z"; [Zimmy](#zimmy)'s real name
Zimmingham	[Zimmy](#zimmy)'s nightmarish version of Birmingham, which is where she and [Gamma](#gamma) are originally from
Zimmy	aka Zeta, a strange girl who is friends with [Gamma](#gamma); from Birmingham originally
